B #########
#        ##
# ######  #
#     ### #
# ######  #
#    ##### 
### #######
#   #    ##
# # ####  #
A #########
