B ##########
#         ##
# ##### #  #
#   ### ## #
###      # #
### ###### #
#          #
#### #######
#      #####
# ####   ###
A ##########