###########
###       #
### ##### B
#   #     #
### # # # #
#   # # # #
# ### # # #
#       # #
# ####### #
#         #
# #########
A #########
