############################ #
# A         #   #######    # #
# # ##### ## # #      # ## # #
# # #   #  # # # #### #    # #
# # # ### # # # #  # ####### #
# # #   # #   # # ##        B#
# # ##### ####### ########   #
# # #####         # ######   #
# # ########### ### #######  #
# # ########### ### #######  #
# #                          #
##############################

